11111111111111111111
1E000000000000000001
10100101000000010101
10100100010100010101
1P0000000000000000C1
11111100010010000111
10000100001100000011
10010000000000000111
10010100000000010001
11111111111111111111