1111111111111111111111111111111111
1C000E000000000000C000000000P010C1
1111111111111111111111111111111111