11111111111111111111
1E000000000000000011
101101100000000101C1
10100100100100010101
1P000000000000010001
11111100100010010111
10000100011100100011
10010000000001000111
1C010110C00010010C01
11111111111111111111