111111111111111111111111111111
1P1000100100011000011111111111
10011C100010000000100110000001
101000101010111100100000011101
101011001010010001C1100011EC01
10001C010000110100010100111101
10101100101011011111C100010101
101010101010000100010101000001
100000101001111000100101111111
111110101C111111101001000001C1
100000101010000000000010101101
101111101010111111111100101101
100000001000000000100000101101
111111111111100100100011101101
1C0000000000001110001000000001
111111111111111111111111111111