11111111111111111111111111111111111111111111111
1C0000000000000000010C1000000001000000001000011
101101100000000001C101C00000101C00000101C0101C1
10100100100100010011010011111010010001010010101
1C001000000000000001000000001000000001000010001
11000100100010001001011001001001001001011010111
11111100011000110010001010010011110010001100011
100000010111000100100E101001001C010010001000011
10011101000001100100011000100011000100011010111
1011C001011100110010000010010000110010001100011
10111101000001000110011000100011000100011010111
10010101000001011100110100101011000100010010111
1P000001C000100000000C00000010C00010010C0100C01
11111111111111111111111111111111111111111111111