1111111111111111111111111111111111
1E0000000000000000C000000000P00001
1111111111111111111111111111111111